0,0,0,0,0,0,0,0,0,0
0,0,0,0,0,0,0,0,0,0
0,-999,0,0,0,0,-999,0,0,0
0,0,0,-999,0,0,0,0,0,0
0,0,0,0,0,0,-999,0,0,0
0,0,0,0,0,-999,0,0,0,0
0,0,0,0,-999,0,0,0,0,0
0,0,0,-999,0,0,0,0,0,0
0,0,-999,0,0,0,0,0,0,0
-999,0,0,0,100,0,0,0,0,0
